0,0,0,0,0,0,0,0
0,0,1,4,0,0,0,0
0,3,0,0,3,0,0,0
0,0,3,0,3,0,3,0
0,0,0,3,3,0,0,0
0,0,3,0,3,0,3,0
0,3,0,0,3,0,0,0
0,0,1,4,0,0,0,0
0,0,0,0,0,0,0,0
