0,0,0,0,0,0,0,0,0,0
0,0,0,3,0,3,0,3,0,0
0,0,3,0,3,0,3,0,3,0
0,3,0,3,0,3,0,3,0,0
0,0,3,0,3,0,3,0,3,0
0,3,0,3,0,3,0,3,0,0
0,0,3,0,3,0,3,1,3,0
0,3,0,3,0,3,0,4,3,0
0,0,3,0,3,1,4,0,0,0
0,0,0,0,0,0,0,0,0,0
