0,0,0,0,0,0,0,0,0,0,0,0,0,0
0,0,1,0,0,0,0,0,0,0,0,0,0,0
0,0,0,0,0,0,0,0,0,0,0,0,0,0
0,0,0,0,0,5,0,0,0,0,0,0,0,0
0,0,0,0,4,0,0,0,0,0,0,0,0,0
0,0,0,5,0,4,7,0,0,0,0,0,0,0
0,0,0,0,0,7,4,7,0,0,0,0,0,0
0,0,0,0,0,0,7,4,7,0,0,0,0,0
0,0,0,0,0,0,0,7,4,7,0,0,0,0
0,0,0,0,0,0,0,0,7,4,7,0,0,0
0,0,0,0,0,0,0,0,0,7,4,7,0,0
0,0,0,0,0,0,0,0,0,0,7,0,4,0
0,0,0,0,0,0,0,0,0,0,0,4,2,0
0,0,0,0,0,0,0,0,0,0,0,0,0,0
